21 9
####################
###.:.##############
#.....####..:..#####
###....####....#####
#############..#####
####################
###...#######...:.##
###.....###....#..##
######..########.###
(1;4)Mókus_sz
(6;16)Banán_sz
(2;12)Pálma_sz