15 6
#########:####
#.........#..#
###.####.##.##
###.##......##
##.....#######
######......:#
